483921657
967345821
251876493
500000000
700000000
100000000
300000000
800000000
600000000