003020000
900305001
001806400
008102900
000000008
006708200
002609500
800203009
005010300