370009006
800103070
000000008
020080050
187000642
500020010
700000000
050602007
200300061